###########
#    1    #
#         ####
#    @       #
#  ########  #
#A           #
#         ####
#        B#
###########
