####################################################
#@                                      E   #      #
#          B#        2   C#D               ##      #
#     ####### ###   ### #########     #####4   #   #
# 1                 #     #     #     ###F     #   #
#       ##A            #     #3                # G #
####################################################
